+---+---+---+---+---+---+---+---+
| S * * * * * * * * * * * *     |
+   +   +   +   +---+---+ * +---+
|   |   |   |   |         * * * |
+---+---+---+   +---+   +---+ * +
|               |           | * |
+   +---+   +---+---+   +---+ * +
|       |       |           | * |
+   +---+---+---+   +---+---+ * +
|   |               |     * * * |
+   +   +---+   +   +---+ * +---+
|   |   |       |   |     *     |
+   +---+   +---+---+   + * +---+
|   |           |       | * * * |
+   +   +---+   +   +   +   + * +
|   |       |   |   |   |   | G |
+---+---+---+---+---+---+---+---+
