+---+---+---+---+---+---+---+---+
| S                             |
+   +   +   +   +---+---+   +---+
|   |   |   |   |               |
+---+---+---+   +---+   +---+   +
|               |           |   |
+   +---+   +---+---+   +---+   +
|       |       |           |   |
+   +---+---+---+   +---+---+   +
|   |               |           |
+   +   +---+   +   +---+   +---+
|   |   |       |   |           |
+   +---+   +---+---+   +   +---+
|   |           |       |       |
+   +   +---+   +   +   +   +   +
|   |       |   |   |   |   | G |
+---+---+---+---+---+---+---+---+